NO ./path_to_the_north_texture.xpm
SO ./path_to_the_south_texture.xpm
WE ./path_to_the_west_texture 
EA ./path_to_the_east_texture
F 22,0100,00
C 225,300,00
11111111111111111111111111111111       11111
		1000000000110000000000001      101
		1011000001110000000000001       1
		1001000000000000000000001
11111111111111110110000011100001                           
100000000011000001110111111111111
11110111111111001100000010001
11110111111111011101010010001
11W00000110101011100000010001
1000000000000000110000001001
10000000000000001101010010N011
110000011101010111110111100111
11110111 1110101 101111010001
11111111 1111111 111111111111







